########################################################################
#                                                                      #
#      ##       #########X    #########    #### X      #########       #
#    ##  ##         #             #O       #   ##          #           #
#    #    X         #             #        #     O         #           #
#     ##            #             #        #   ##          #           #
#      ##        X  # O           #        ####            #    P      #
#       ##          #             #        #               #           #
#    #O   #         #             #        #              O#           #
#     ####      #########         #        #           #########       #
#                                                          X           #
#O                           X                                         #
########################################################################
