####################################################################################################
#                                                                                                  #
#   ###  ###        ###  ###            #              ###  ###       ####  ###        O           #
#   ###   ###       ###    #           ###            ###     #        ###    #                    #
#   ###   ###       ###  #             ####          ###               ###  #                      #
#   ###   ##        ######            # ###          ###               ######                      #
#   #######         ### ##            #  ###         ###               ### ##                      #
#   ###             ###  #           #   ###         ###               ###  #                      #
#   ###             ###     #        ########        ####     #        ###    #                    #
#   ###             ###   ##              ###         ####   ##        ###   ##                    #
#   ####           #########       ###    ####           ####         ########                     #
#                                                                                                  #
#                     #####               ####                                                     #
#                   ##     #            ###   ##                       X                           #
#                  ##       #           #       #                                                  #
#                  ##        #         #        ##                                                 #
#                   ##        #        #        #                                                  #
#                    ##        #      #        ##                                                  #
#                    ##         #     #        ##                                                  #
#                     ##         #    #        #                                                   #
#                      #         ##   #       ## ###                                               #
#                       ##        #   #      ####   #                                              #
#                       ##        ##  ##     ##      #                                             #
#                        ##       ##  ##     ##      #                                             #
#                         ##      ## ##     ##      ##                                             #
#                         ###      ###     ##      ######                                          #
#                          ###             #########    ##                                         #
#                           ##           ##### ######    ##                                        #
#                            #      ###### # ####   ### ###                                        #
#                            ## #####      ######   #######                                        #
#                             ###            #############                                         #
#                            ##              ########## ##                                         #
#                            #          ######      ##  ##                                         #
#                           ##          ##              #                                          #
#                           ##     #######             ##                                          #
#                            ##    ##### ##            ##                                          #
#                             ###        ##            ##                                          #
#                               ##        ##           #                                           #
#                                ###                  ##                                           #
#                                 ###                 ##                                           #
#                                  ###                ##                                           #
#                                   ###       P       ##                                           #
#                                   ##                #                                            #
#                                    ##               #                                            #
#                                    ##               #                                            #
#                                     #               #                                            #
#                                                     #                                            #
#                                                                                                  #
#                                                                                                  #
####################################################################################################